those = “esses”, “essas”, “aqueles” e “aquelas” ex: those things are bad
exposure = exposição, revelação
pack up = empacotar
highly = altamente
come = vir, vem
thought= pensar
worse = pior
own club = próprio, ter
content = contente
ordinary = comum, default
annoying = irritante
catch = pegar, obter
spacing out = espaçamento
seeing = falanado
waving = acenando
least = ao menos
might draw to 
smart = inteligente
fells a litle = sente um pouco
since = Desde a
each = cada
out of my league = fora do meu alcance
other = de outros
glance = olhar
reach = alcançar
cross = cruzar
anyay = de qualquer maneira
less = menos
together = juntos
looking = olhando
either = qualquer
draw near = aproximar
worried = preocupado
oversleep = dormir demais
incrisingly = incrivelmente
daily = Diário
commute = trajeto
specled = especulado
got tired = cansado
waiting up = esperando
crosswalk = faixa de pedestre
weird = estranhas
couple = casal
brought = trouxe
caught
way to kill the atmosphere
stare = olhar fixamente
catch up to me
always = sempre
smartest
whose = cujo